{
    "tiles": [
        "############################",
        "#............##............#",
        "#.####.#####.##.#####.####.#",
        "#o####.#####.##.#####.####o#",
        "#..........................#",
        "#.####.##.########.##.####.#",
        "#......##....##....##......#",
        "######.#####.##.#####.######",
        "######.##..........##.######",
        "#............##............#",
        "############################"
    ],

    "pacman_spawn": [14, 9],

    "ghost_spawns": [
        [13, 6],
        [14, 6],
        [15, 6]
    ]
}
