{
    "tiles": [
        "############################",
        "#o........................o#",
        "#.####.##########.####.###.#",
        "#......##......##......##..#",
        "######.##.####.##.####.#####",
        "#............##............#",
        "#.#####.####.##.####.#####.#",
        "#..........................#",
        "############################"
    ],

    "pacman_spawn": [1, 1],
    "ghost_spawns": [
        [14, 3],
        [10, 6]
    ]
}
