{
  "tiles": [
    "############################",
    "#............##............#",
    "#.####.#####.##.#####.####.#",
    "#o####.#####.##.#####.####o#",
    "#.####.#####.##.#####.####.#",
    "#..........................#",
    "#.####.##.########.##.####.#",
    "#.####.##.########.##.####.#",
    "#......##....##....##......#",
    "######.#####.##.#####.######",
    "######.#####.##.#####.######",
    "######.##..........##.######",
    "######.##.###--###.##.######",
    "######.##.#      #.##.######",
    "######.##.###--###.##.######",
    "######.##..........##.######",
    "######.##.########.##.######",
    "######.##.########.##.######",
    "#............##............#",
    "#.####.#####.##.#####.####.#",
    "#.####.#####.##.#####.####.#",
    "#o..##................##..o#",
    "###.##.##.########.##.##.###",
    "###.##.##.########.##.##.###",
    "#......##....##....##......#",
    "#.##########.##.##########.#",
    "#.##########.##.##########.#",
    "#..........................#",
    "############################"
  ],

  "pacman_spawn": [1, 2],

  "ghost_spawns": [
    [13, 13],
    [14, 13],
    [12, 13],
    [11, 13]
  ],

  "ghost_house_area": [
    [12, 13], [13, 13], [14, 13],
    [12, 14], [13, 14], [14, 14]
  ],

  "ghost_house_door": [13, 12],

  "pellets": [],
  "powerups": []
}
