{
  "tiles": [
    "#########################",
    "#........###............#",
    "#.####.#......#.#######.#",
    "#o####.#.###.#.#######o.#",
    "#.####.#.###.#.#######..#",
    "#.......................#",
    "#.####.########.#######.#",
    "#.####.########.#######.#",
    "#.....#....G....#.......#",
    "#####.#.#######.#.#######",
    "#####.#.#     #.#.#######",
    "#####.#.# ### #.#.#######",
    "#........# G #..........#",
    "#.#######.#.#.#######.###",
    "#.#######.#.#.#######.###",
    "#o....................o.#",
    "#########################"
  ],

  "pacman_spawn": [1, 1],
  "ghost_spawns": [
    [11, 8],
    [10, 12]
  ],

  "pellets": [],
  "powerups": []
}
