#########################
#........###...........#
#.####.#.....#.#######.#
#o####.#.###.#.#######o#
#.####.#.###.#.#######.###
#........................#
#.####.#########.#######.#
#.####.#########.#######.#
#.....#....G....#........#
#####.#.#######.#.########
#####.#.#     #.#.#######
#####.#.# ### #.#.########
#........# G #...........#
#.#######.# #.#######.####
#.#######.#.#.#######.###
#o.....................o#
#########################
